%%%%%%%%
%. ;  .%
%   P  %
%;%%%% %
% % ,  %
% % %%%%
%.%;  ,%
%%%%%%%%
