%%%%%%%%%%%%%%%%%%%%%%%%%%%%%%
%.    ; % % %             .%,%
%       % % %%%%%% %%%%%%% % %
%       %        %     % %   %
%%%%% %%%%% %%% %% %%%%% % %%%
%   % % % %   %    %     %   %
% %%% % % % %%%%%%%% %%% %%% %
%;      %     %%     % % %   %
%%% % %%%%%%% %%%% %%% % % % %
% %           %%     %  ,  % %
% % %%%%% % %%%% % %%% %%% % %
%   %     %      % %   % %%% %
%,  %P%%%%%      % %%% %    ;%
%%%%%%%%%%%%%%%%%%%%%%%%%%%%%%